A	А
B	Б
V	В
G	Г
D	Д
E	Е
JO	Ё
ZH	Ж
Z	З
I	И
JJ	Й
K	К
L	Л
M	М
N	Н
O	О
P	П
R	Р
S	С
T	Т
U	У
F	Ф
KH	Х
C	Ц
CH	Ч
SH	Ш
SHH	Щ
Y	Ы
EH	Э
JU	Ю
JA	Я
a	а
b	б
v	в
g	г
d	д
e	е
jo	ё
zh	ж
z	з
i	и
jj	й
k	к
l	л
m	м
n	н
o	о
p	п
r	р
s	с
t	т
u	у
f	ф
kh	х
c	ц
ch	ч
sh	ш
shh	щ
''	ъ
y	ы
'	ь
eh	э
ju	ю
ja	я